{
  "width": 8,
  "height": 8,
  "startX": 0,
  "startY": 0,
  "startDir": "E",
  "bagCount": 0,
  "beepers": [],
  "walls": [
    "e,0,7",
    "e,1,7",
    "n,1,6",
    "e,2,7",
    "e,3,7",
    "e,2,6",
    "e,3,6",
    "e,2,5",
    "e,3,5",
    "e,2,4",
    "e,3,4",
    "n,3,3",
    "e,4,7",
    "e,5,7",
    "e,4,6",
    "e,5,6",
    "n,5,5",
    "e,6,7",
    "e,6,6",
    "e,6,5",
    "n,7,4"
  ]
}
